FFWWMWFWPPFWPWPWFMFM
PFMPPWFPFWMWPMWMFFPW
WPFPFWFFPMFPFPMWWFWM
WMFFPFFPMPMPPPPFFPFW
FPPMFPPWWMWPFWMWFPFW
MWPWFWPFWMWPPWMFMFWF
PFMPFWFWMFMWPPFPWFFP
FMPMFPMFFWPPPFPPMFPM
WMFPMFMFPWPMWPMFPMWP
WPPPMWMFPMFMPPWPFPWM
WFPWFMFMFFWPWPMWMPPP
PFFPWPPWPMPFFMFPMWMF
MPWPFPFFPWFWPFFWMWPW
FPFPMWFPWPPFFPWMPMFP
MFWWMWFMWPFMPWMWFWPF
PWPFWMPWFWFPPFWWMWPW
WMPWMPFWPFWPWWMFFWPW
FFPFWPWPMPMWMFFMFWPF
WMFPWPPFMFWFPMWFPMPM
MPWMFWMFFWMFWMFWMFWM